[
	{
		"id": 1,
		"difficulty" : 1,
		"enemy": [
			[1,1,1,1,1,1],[1,1,1,1,1,1],[1,1,1,1,1,1],[1,1,1,2,1,1],[1,1,1,2,1,1]
		]
	},
	{
		"id": 2,
		"difficulty" : 1.2,
		"enemy": [
			[1,1,1,1,1,2,1],[1,1,1,1,2,1,1],[1,1,1,2,1,1,1],[1,1,1,2,1,1,1],[1,1,2,1,2,1,1]
		]
	},
	{
		"id": 3,
		"difficulty" : 1.2,
		"enemy": [
			[1,1,1,2,1,1,2,1],[1,2,1,2,1,1,2,1],[1,2,1,2,1,1,2,1],[1,2,1,2,1,1,2,2,1],[1,1,2,1,2,1,2,2,2,1]
		]
	},
	{
		"id": 4,
		"difficulty" : 1.3,
		"enemy": [
			[1,1,1,2,1,1,2,2,1,1],[1,2,1,2,1,1,2,1,1,2],[1,2,1,2,1,1,2,1,2],[1,2,1,2,1,1,2,2,1,1],[1,1,2,1,2,1,2,2,2,1,1]
		]
	},
	{
		"id": 5,
		"difficulty" : 1.3,
		"enemy": [
			[1,2,1,2,2,2,1,2,2],[1,2,1,2,2,1,2,1,1,2,1],[1,2,1,2,1,1,2,1,2,1,1,1,2],[1,2,1,2,1,1,3,1,1,2,1,2,1,2,2],[1,1,3,1,2,1,2,3,2,1,2,1,1,2,1,1,2,1,3]
		]
	},
	{
		"id": 6,
		"difficulty" : 1.3,
		"enemy": [
			[1,2,2,2,1,2,2,2,1,2,2],[1,2,1,2,1,1,2,1,2,1,1,2,1],[1,2,1,2,1,1,2,1,1,3,1,2,1,1,1,2],[1,2,1,2,1,1,3,1,1,2,1,3,1,1,1,2,2],[1,1,3,2,2,1,2,3,2,1,2,1,1,2,1,1,2,1,1,2,1,3]
		]
	},
	{
		"id": 7,
		"difficulty" : 1.4,
		"enemy": [
			[1,2,2,2,1,2,2,2,1,2,2,1,2],[1,2,1,2,1,1,2,1,2,1,1,1,2,2,1],[1,2,1,2,1,1,2,1,1,3,1,1,2,2,1,1,1,2],[1,2,1,2,1,1,3,1,1,2,1,2,1,3,1,1,1,2,2],[1,1,3,2,2,1,2,3,2,1,2,1,2,1,1,2,1,1,2,1,1,2,1,3]
		]
	},
	{
		"id": 8,
		"difficulty" : 1.5,
		"enemy": [
			[1,2,2,2,1,3,2,2,1,2,2,1,2,2,2,2,3],[1,2,1,2,1,2,2,3,2,1,2,2,2,2,1,2,2,1],[1,2,1,2,1,2,2,1,1,3,1,1,2,3,1,1,1,2],[1,2,1,2,1,2,1,3,2,1,2,3,1,1,2,1,2,1,3,1,1,1,2,2],[1,1,3,2,2,2,2,3,2,1,2,1,2,3,1,2,1,1,2,1,1,2,1,3]
		]
	},
	{
		"id": 9,
		"difficulty" : 1.5,
		"enemy": [
			[1,2,2,2,1,3,2,2,1,2,2,1,2,2,2,2,3,2,2,2,3],[1,2,1,2,1,2,2,3,2,1,2,2,2,2,1,2,2,1,2,2,2,3],[1,2,1,2,1,2,2,1,1,3,1,1,2,3,1,1,1,2,2,2,2,3],[1,2,1,2,1,2,1,3,2,1,2,3,1,1,2,1,2,1,3,1,1,1,2,2,2,2,2,3],[1,1,3,2,2,2,2,3,2,1,2,1,2,3,1,2,1,1,2,1,1,2,1,3,2,2,2,3]
		]
	},
	{
		"id": 10,
		"difficulty" : 1.8,
		"enemy": [
			[1,2,2,2,1,3,2,2,1,2,2,1,2,2,2,2,3,2,2,2,3,2,2,3],[1,2,1,2,1,2,2,3,2,1,2,2,2,2,1,2,2,1,2,2,2,3,2,2,3],[1,2,1,2,1,2,2,1,1,3,1,1,2,3,1,1,1,2,2,2,2,3,2,2,3],[1,2,1,2,1,2,1,3,2,1,2,3,1,1,2,1,2,1,3,1,1,1,2,2,2,2,2,3,2,2,3],[1,1,3,2,2,2,2,3,2,1,2,1,2,3,1,2,1,1,2,1,1,2,1,3,2,2,2,3,2,2,3]
		]
	}
]